Your name is Lana, a twelve-year-old girl. You just moved to a new house with your Father and just getting settled in your room. You are trying to unpack your belongings, and getting comfortable in this strange new place. Your Father just left to buy some groceries. The ancient house creaks and sighs at night. It is filled with dust and ancient, bizarre objects. You wonder what secrets this house holds.

The Mirror Queen
An Interactive Fiction by Riadiani Marcelita
Release 1 / Serial number 161128 / Inform 7 build 6M62 (I6/v6.33 lib 6/12N) SD

Lana's Bedroom
Your room is a small square of a space, modest enough for a twelve-year-old. The walls are bare and painted a shade of pale yellow. The hardwood floor is recently scrubbed clean.

The bed is neatly made.

There are a lamplight, a folded piece of newspaper, and an old scrapbook on the desk.

What an odd, ancient-looking thing! It is a full-sized mirror. Is there something glittering over the surface of the mirror?

You can also see a newspaper, a suitcase and a scrapbook here.

>x bed
You see nothing special about the bed.

>x suitcase
You have not unpacked. You suddenly feel a cold draft and decides to put on a jacket. Where is this cold draft coming from? There are no windows on your room.

>x mirror
You come closer to the mirror and see that it is glimmering with a strange, twinkling light. Your reflection seems to grow hazy before your eyes, and it soon disappears. An image of what seems like a large hallway appears before you. A cold draft blows your hair back and sends your body shivering. Curious, you place your hand on the mirror. Your hand goes through the mirror! You realize that the mirror could be a gate to another dimension -- to the mysterious hallway. Your curiosity aroused, you decide to let yourself slip into this new, unexplored realm.

>e
You can't go that way.

>w
The Hallway

* * *

>x lamplight
You can't see any such thing.

>x light
You can't see any such thing.

>x newspaper
You glance at the local newspaper your Father bought earlier. One article catches your eye. A local 9-year-old boy just went missing a couple days ago. His parents swore he was just playing games in his room all day long. This is the 15th missing children's case in the area this year alone.

>x bed
You see nothing special about the bed.

* * *

>x mirror
You come closer to the mirror and see that it is glimmering with a strange, twinkling light. Your reflection seems to grow hazy before your eyes, and it soon disappears. An image of what seems like a large hallway appears before you. A cold draft blows your hair back and sends your body shivering. Curious, you place your hand on the mirror. Your hand goes through the mirror! You realize that the mirror could be a gate to another dimension -- to the mysterious hallway. Your curiosity aroused, you decide to let yourself slip into this new, unexplored realm.

>x desk
You see nothing special about the desk.

* * *

>w
The Hallway
You have stepped into a hallway of what appears to be a castle made out of... glass? The smooth, polished floor feels almost slippery under your sneakers. The icy air turns your breath into mist. The translucent walls around you are bare; you could see your own distorted reflection on its crystalline surface. You look up and the ceiling is lost in a cluster of dark gray clouds. You are terrified, but there is no turning back. You see light in front of you. What could it be?

A door made of glass with chipped edges and a cracked handle. Wisps of strange light slither around its edges. It must lead to another room in the palace!

>n
The Mirror Chamber
You enter a room that is even colder than the hallway. You see at least a dozen mirrors similar to the one you just walked through, lined up against the walls. What is going on here?

Are your eyes playing tricks on you, or is that a dark shadow looming over the mirror surfaces?

Are those glowing crystals?

>x mirrors
You come closer to one of the mirrors and almost let out a scream. What you see is not your reflection, but the face of a young boy. His eyes are closed, his face ghastly white, his lips a bruised blue color. He is nothing but skin and bones, and he seems to be hovering over the mirror's surface, his skeletal body unmoving.

You realize there are children in all the other mirrors as well. Each of them seem to be her age, and all of them are unconscious.

You stare at the boy's face and felt strangely familiar. Where have you seen him before? you wonder, as your hand unknowingly make their way towards the mirror's surface.

>touch mirrors
You touch the mirror. It feels cool and lucid under your fingers.

Suddenly, the boy behind the mirror snapped his eyes open. You let out a scream and take a step back.

"Help me!" the boy screams, his chapped lips making him look even more terrifying. "Help me, please! The Queen is coming!"

Your first instinct is to run away! Go back to the safety of your room! But... Queen, he said? What Queen? You are itching to prompt the boy further for more information.

>ask the boy about the queen
You can't see any such thing.

>ask the boy
You can't see any such thing.

* * *

>touch mirrors
You touch the mirror. It feels cool and lucid under your fingers.

Suddenly, the boy behind the mirror snapped his eyes open. You let out a scream and take a step back.

"Help me!" the boy screams, his chapped lips making him look even more terrifying. "Help me, please! The Queen is coming!"

Your first instinct is to run away! Go back to the safety of your room! But... Queen, he said? What Queen? You are itching to prompt the boy further for more information.

>ask
What do you want to ask yourself for?

>ask questions
You can't see any such thing.

>ask question
You can't see any such thing.

>ask mirrors
You can only do that to something animate.

>ask boy
You can't see any such thing.

>ask the boy
You can't see any such thing.

* * *

>n
The Mirror Chamber
You enter a room that is even colder than the hallway. You see at least a dozen mirrors similar to the one you just walked through, lined up against the walls. What is going on here?

Are your eyes playing tricks on you, or is that a dark shadow looming over the mirror surfaces?

Are those glowing crystals?

>x mirror
You can't see any such thing.

>x mirrors
You come closer to one of the mirrors and almost let out a scream. What you see is not your reflection, but the face of a young boy. His eyes are closed, his face ghastly white, his lips a bruised blue color. He is nothing but skin and bones, and he seems to be hovering over the mirror's surface, his skeletal body unmoving.

You realize there are children in all the other mirrors as well. Each of them seem to be her age, and all of them are unconscious.

You stare at the boy's face and felt strangely familiar. Where have you seen him before? you wonder, as your hand unknowingly make their way towards the mirror's surface.

>touch mirrors
You touch the mirror. It feels cool and lucid under your fingers.

Suddenly, the boy behind the mirror snapped his eyes open. You let out a scream and take a step back.

"Help me!" the boy screams, his chapped lips making him look even more terrifying. "Help me, please! The Queen is coming!"

"Who is this Queen you are talking about?" you ask.

"The Mirror Queen," the boy's lips quiver. "She is the owner of this palace. She is an otherwordly creature that lures human children into her palace through her shimmering mirrors. She enchants us to stay here with her, forever. She then entraps us in this mirror and feeds off our life source to stay alive. I am the latest child she's abducted, and she has sucked half my soul away. Please help me! I want to return to my Mommy and Daddy!"

You realize where you have seen the boy before -- he is the missing child you just saw in the newspaper.

"How do I help you escape?" you ask.

"Defeat the Queen," the boy says. "She lives in her chamber at the end of this hall. Take those crystal lights with you, if you haven't had one already. These hold magical powers upon contact with human skin."

You promise the boy you will try your best to defeat the Queen and save him. You move forward to go to the Queen's Chamber. You make sure you have a crystal lights to have as your weapon.

>n
The Queen's Chamber
It is a royal chamber like no other -- the ceiling is so high it is invisible; a crystal chandelier hangs by a silver chain, and it is adorned with more glowing crystals. The glass floor is etched with intricate designs, one best suited for royalty. On a raised platform in the middle of the chamber the Queen is seated on her glass throne.

You can see a Queen here.

>x queen
The Queen is, no doubt, the most beautiful creature Lana has ever laid her eyes on. She has a wave of dark curls that fall gracefully down her shoulders. Her eyes are the most brilliant shade of blue, and they seem to sparkle under the glare of the crystal lights. Her tall, lean figure is draped in a silver dress that seems to reflect the colors of the rainbows. It sways around her glass-slippered feet whenever she moves.

"Greetings, Lana. I have been waiting for you."

>answer queen
(to yourself)
"Who are you and how did you know my name?"

The Queen stands and makes her way slowly towards you. "I know what your heart truly desires. I know the person you miss the most."

The next second, the Queen's face has transformed, to your surprise, to your Mother's. She is smiling down at you, opening her arms at you. You remember how warm her arms used to be.

"Come and stay here with me, darling," she says in her beautiful, sing-song voice you miss terribly. "You will be safe with me. We will never be apart, ever again."

You grow even more confused. You need to defeat the Queen and get out of there! But at the same time, your heart aches for your mother's arms. You miss her, more than anything in this world, and your heart longs to be with her once more.

"What do you say, sweetheart?" she asks. "Are you going to come with me?"

What should you answer? YES? Or NO?

>YES
You run into your mother's embrace, tears falling down your face.

"Sweet child," she coos. "You will be mine forever."

Seconds later, a sense of dread fills your heart. Your senses return to you, but it's too late -- your mother has transformed back into the evil Mirror Queen. She grips you, tight, with her claw-like hands, and with her magical powers entraps you in one of her mirrors.

"Let me out!" you yell at the top of your lungs.

"Don't worry, my sweet Lana," the Queen smiles. "There is plenty of time to spare before dinner time."

* * *

>n
The Mirror Chamber
You enter a room that is even colder than the hallway. You see at least a dozen mirrors similar to the one you just walked through, lined up against the walls. What is going on here?

Are your eyes playing tricks on you, or is that a dark shadow looming over the mirror surfaces?

Are those glowing crystals?

>n
The Queen's Chamber
It is a royal chamber like no other -- the ceiling is so high it is invisible; a crystal chandelier hangs by a silver chain, and it is adorned with more glowing crystals. The glass floor is etched with intricate designs, one best suited for royalty. On a raised platform in the middle of the chamber the Queen is seated on her glass throne.

You can see a Queen here.

* * *

>x queen
The Queen is, no doubt, the most beautiful creature Lana has ever laid her eyes on. She has a wave of dark curls that fall gracefully down her shoulders. Her eyes are the most brilliant shade of blue, and they seem to sparkle under the glare of the crystal lights. Her tall, lean figure is draped in a silver dress that seems to reflect the colors of the rainbows. It sways around her glass-slippered feet whenever she moves.

"Greetings, Lana. I have been waiting for you."

>ask
(yourself for the Queen)
You are carrying nothing.

>ask queen
You can only do that to something animate.

>answer
I didn't understand that sentence.

>answer the queen
(to yourself)
"Who are you and how did you know my name?"

The Queen stands and makes her way slowly towards you. "I know what your heart truly desires. I know the person you miss the most."

The next second, the Queen's face has transformed, to your surprise, to your Mother's. She is smiling down at you, opening her arms at you. You remember how warm her arms used to be.

"Come and stay here with me, darling," she says in her beautiful, sing-song voice you miss terribly. "You will be safe with me. We will never be apart, ever again."

You grow even more confused. You need to defeat the Queen and get out of there! But at the same time, your heart aches for your mother's arms. You miss her, more than anything in this world, and your heart longs to be with her once more.

"What do you say, sweetheart?" she asks. "Are you going to come with me?"

What should you answer? YES? Or NO?

    *** Regardless of the outcome, you have been very brave. ***

Would you like to RESTART, RESTORE a saved game, QUIT or UNDO the last command?

* * *

>x queen
The Queen is, no doubt, the most beautiful creature Lana has ever laid her eyes on. She has a wave of dark curls that fall gracefully down her shoulders. Her eyes are the most brilliant shade of blue, and they seem to sparkle under the glare of the crystal lights. Her tall, lean figure is draped in a silver dress that seems to reflect the colors of the rainbows. It sways around her glass-slippered feet whenever she moves.

"Greetings, Lana. I have been waiting for you."

>answer queen
(to yourself)
"Who are you and how did you know my name?"

The Queen stands and makes her way slowly towards you. "I know what your heart truly desires. I know the person you miss the most."

The next second, the Queen's face has transformed, to your surprise, to your Mother's. She is smiling down at you, opening her arms at you. You remember how warm her arms used to be.

"Come and stay here with me, darling," she says in her beautiful, sing-song voice you miss terribly. "You will be safe with me. We will never be apart, ever again."

You grow even more confused. You need to defeat the Queen and get out of there! But at the same time, your heart aches for your mother's arms. You miss her, more than anything in this world, and your heart longs to be with her once more.

"What do you say, sweetheart?" she asks. "Are you going to come with me?"

You know you need to say NO.

>no
"No! This is a trick!" your brain sends off an alarm, and you snap out of the Queen's illusion with a newfound wave of bravado. "How dare you pretend to be my Mother! She is nothing like you!"

You thrust the crystal light at the Queen's heart. Imbued with the magical powers harvested from your human skin, the crystal destroyed the Queen's heart. With a deafening, inhumane wail, the Queen shatters into a million tiny pieces.

After your initial shock, what just happened finally seeped in. You have defeated the Queen! You won! You hurriedly returns to the boy and finds him out of the mirror. You help him and the rest of the entrapped children out of the mirrors, lead them back safely to the human world, and return them to their parents.

    *** You have been very brave. ***

Would you like to RESTART, RESTORE a saved game, QUIT or UNDO the last command?

>undo
The Queen's Chamber
[Previous turn undone.]

>say no
(to yourself)
"Who are you and how did you know my name?"

The Queen stands and makes her way slowly towards you. "I know what your heart truly desires. I know the person you miss the most."

The next second, the Queen's face has transformed, to your surprise, to your Mother's. She is smiling down at you, opening her arms at you. You remember how warm her arms used to be.

"Come and stay here with me, darling," she says in her beautiful, sing-song voice you miss terribly. "You will be safe with me. We will never be apart, ever again."

You grow even more confused. You need to defeat the Queen and get out of there! But at the same time, your heart aches for your mother's arms. You miss her, more than anything in this world, and your heart longs to be with her once more.

"What do you say, sweetheart?" she asks. "Are you going to come with me?"

You know you need to say NO.

* * *

>x door
You see nothing special about the chipped door.

>x
(the chipped door)
You see nothing special about the chipped door.

>n
The Mirror Chamber
You enter a room that is even colder than the hallway. You see at least a dozen mirrors similar to the one you just walked through, lined up against the walls. What is going on here?

Are your eyes playing tricks on you, or is that a dark shadow looming over the mirrors" surfaces?

Are those glowing crystals?

* * *

>e
You can't go that way.

>w
The Hallway
You have stepped into a hallway of what appears to be a castle made out of... glass? The smooth, polished floor feels almost slippery under your sneakers. The icy air turns your breath into mist. The translucent walls around you are bare; you could see your own distorted reflection on its crystalline surface. You look up and the ceiling is lost in a cluster of dark gray clouds. You are terrified, but there is no turning back. You see light in front of you. What could it be?

A door made of glass with chipped edges and a cracked handle. Wisps of strange light slither around its edges. It must lead to another room in the palace!

* * *

>x door
You see nothing special about the chipped door.

>x chipped door
You see nothing special about the chipped door.

>open door
To open the door is to move to the next room in the palace. Further on north if you dare!

>n
The Mirror Chamber
You enter a room that is even colder than the hallway. You see at least a dozen mirrors similar to the one you just walked through, lined up against the walls. What is going on here?

Are your eyes playing tricks on you, or is that a dark shadow looming over the mirrors" surfaces?

Are those glowing crystals?

>x crystals
You can't see any such thing.

>x crystal
A cluster of what appears to be glowing crystals huddle around the corners of the chamber and between the mirrors. They are cut into finely shaped pieces, at least as long and big as your arm. You notice how sharp the tips are. A dim, wispy light seems to radiate off the crystals. They provide the only source of lighting in the chamber. You realize they are removable. It might be wise to carry around one of these, you think, as it is truly very dark in here.

>take crystal
You have picked up a crystal light. It is now your source of light in this somber chamber.

>x mirror
You can't see any such thing.

* * *

>ask
What do you want to ask yourself for?

>question
You can't see any such thing.

>ask boy
You can't see any such thing.

>ask question
You can't see any such thing.